
        WE ./textures/backroom.xpm
   EA ./textures/backroom.xpm


NO ./textures/backroom.xpm
SO ./textures/backroom.xpm


F 255,245,150
C 255,245,150

           1111111111111111111111111111111111111
           1000000000001000000000001000000000001
           1000100000000000001000000000000001001
           1000000000001000000000001000000000001
111111111111111111101111111110111111111111111111
10000000000100000000000100000000000100000000000111
10000110000100110000100100000000010100000010000101
10000110000000110000000000001100000000000000000001
10E00000000100000010000100001100000100100000100101
10000000000100000000000100000000000100000000000101
11111111111111011111111111111011111111111101111111
           1000000001000000000000001000000000001
           1000000001001100000010001000000100001
           1111011111001100110000000001100000001
           1000000001000000110001001001100001001
           1000000000000000000000001000000000001
           1111111111111111111111111111111111111
