
        WE ./textures/backroom.xpm
   EA ./textures/backroom.xpm


NO ./textures/backroom.xpm
SO ./textures/backroom.xpm


F 255,245,150
C 255,245,150

           1111111111111111111111111111111111111
           1000000000001000000000001000000000001
           1000000000000000000000000000000000001
           1000000000001000000000001000000000001
111111111111111111101111111110111111111111111111
10000000000100000000000100000000000100000000000111
10000000000100000000000100000000000100000000000101
1000000000000000000000000000000000000000000000001
10E00000000100000000000100000000000100000000000101
10000000000100000000000100000000000100000000000101
11111111111111011111111111111011111111111101111111
           1000000001000000000000001000000000001
           1000000001000000000000001000000000001
           1111011111000000000000000000000000001
           1000000001000000000000001000000000001
           1000000000000000000000001000000000001
           1111111111111111111111111111111111111
