														F 									               153				, 204  	,			255				   					
		    			
					
							
				WE ./textures/green.xpm
									EA ./textures/blue.xpm


			NO ./textures/red.xpm
	 																											                  SO ./textures/grey.xpm



			C 				128			,	128	,																									128
		
		
		
		
   
   


111111111111
10000000011
101100000111
100100N00001
100000000001
111111111111
