NO ./textures/grey.xpm
SO ./textures/blue.xpm
WE ./textures/green.xpm
EA ./textures/red.xpm

C 153,204,255
F 155,75,0

11111111111111111111111111111
10000000001100000000000000001
10110000011100000000000000001
10010000000000000000000000001
11111111101100000111000000001
10000000001100000111011110111
11110111111111011100000010001
11110111111111011101010010001
11000000110101011100000010001
10000000000000001100000010001
10000000000000001101010010001
11000001110101011111011110N01
11110111111101011101111010001
11111111111111111111111111111
