
NO ./textures/grey.xpm
SO ./textures/blue.xpm
WE ./textures/green.xpm
EA ./textures/red.xpm

C 153,204,255
F 155,75,0

              1              
             1S1             
            10001            
           1000001           
          100000001          
       111000000000111       
    111000000000000000111      
 111000000000000000000000111      
10000000000000000000000000001
 111000000000000000000000111      
    111000000000000000111      
       111000000000111
      10000000100000001
     100000011 110000001
    10000111     11100001
   100011           110001
  11111               11111
