
WE ./textures/green.xpm
EA ./textures/blue.xpm


NO ./textures/red.xpm
					
					
					
SO ./textures/grey.xpm


F 153                                   ,204		,255
C 128,128,			128

111111111111                           11111111111111111 
10000000011                            10000000000000001
101100000111                           1E100001100000101
100100000001                           10100000110000101
100000000001                           10000000000000001
111111111111                           11111111111111111
